NO ./path_to_the_north_texture
SO ./path_to_the_south_texture
WE ./path_to_the_west_texture



EA ./path_to_the_east_texture


C 220,100,0
F 225,30,0



111111111111111111111111111111111
111111  1000000000000000000000001
1000011111010000000000000011100011
11000000000100111100100001111111111
100011111111001 1000110000000000111
11111111100000111000000000000111111
11000000000010000000000001111111
 11111111111111100000000000000011
1100001        10001000000011111111
11000011111 1111000111100000111111111
10000000001110000001 100000111
110000011111000111111111110111
11111111 1110111 10111010100W11
11111111 1111111 1111111111111
