NO ./path_to_the_north_texture
SO ./path_to_the_south_texture
WE ./path_to_the_west_texture



EA ./path_to_the_east_texture


C 220,100,0
F 225,30,0



1111
11W11
1111
