NO ./textures/StoneHitler.xpm
SO ./textures/wall.xpm
WE ./textures/Blue.xpm
EA ./textures/Stoneflag.xpm

C 63, 0, 0
F 	0, 0, 139

111111111111
100000N00001
111111111111