NO ./textures/StoneHitler.xpm
SO ./textures/wall.xpm
WE ./textures/Blue.xpm
EA ./textures/Stoneflag.xpm

C 102,178,255
F 64,64,    64

11111111
10E01111
10001111
11111111