NO ./textures/StoneHitler.xpm
SO ./textures/wall.xpm
WE ./textures/Blue.xpm
EA ./textures/Stoneflag.xpm

C 102,178,255
F 64,64,    64

1111111111
11111E0101
 111111111