C 255,0,0

NO ./textures/StoneHitler.xpm
SO ./textures/wall...xpm
WE ./textures/Blue.xpm
EA ./textures/Stoneflag.xpm


F 64,64,64

1111111111111111111111111111111111111111
1110000000000000000000000000000000111111
1110000000000000000000000000000000111111
1110000000000000000000000000000000111111
1110000000000000000000000000000000111111
11100000000000000W0000000000000000111111
1110000000000000000000000000000000111111
1110000000000000000000000000000000111111
1110000000000000000000000000000000111111
1110000000000000000000000000000000111111
1111111111111111111111111111111111111111