C 	0, 0, 139

NO ./textures/StoneHitler.xpm
SO ./textures/wall.xpm
WE ./textures/Blue.xpm
EA ./textures/Stoneflag.xpm

F 63, 0, 0
1111111111111111111111111111111111111111111
1000001101111011110111101111011110000000001
1000001101111011110111101111011100000000111
11000001111111111100000000001111111111111
100011110111101111000011000001110111101111
11111111111111111100001100N001111111111111
10001111011110111100000000001110111101111
11111111111111111111111111110111111111111111
                       1111100000000000000111
                       101111011110111101111
                       101111011110111101111
                       111111111111111111111
                       101111011110111101111
                       111111111111111111111
                       101111011110111101111
                       111111111111111111111