C 	0, 0, 139

NO ./textures/StoneHitler.xpm
SO ./textures/Blue.xpm
WE ./textures/wall.xpm
EA ./textures/Stoneflag.xpm

F 63, 0, 0



1111111111111111111111111111111111111111111
1000001110000000000000001110000000000000011
1000000000000000000000001110000000000000011
10000000N0000000000000000000000000000000011
1000000000000000000000001110000000000000011
1000000000000000000000001110000000000000011
1000001110000000000000001110000000000000011
1111111111111111111111111111111111111111111