NO ./textures/StoneHitler.xpm
SO ./textures/wall.xpm
WE ./textures/Blue.xpm
EA ./textures/Stoneflag.xpm

C 102,178,255
F 64,64,    64

1111111111111111111111111111111111111111111
10E0001101111011110111101111011110111101111
1000001101111011110111101111011110111101111
1100000111111111111111111111111111111111111
1000111101111011110111101111011110111101111
1111111111111111111111111111111111111111111
1000111101111011110111101111011110111101111
1111111111111111111111111111111111111111111