NO ./textures/StoneHitler.xpm
SO ./textures/wall.xpm
WE ./textures/Blue.xpm
EA ./textures/Stoneflag.xpm

C 102,178,255
F 64,64,    64

111111111111111111111111111111111
111111  1000000000000000000000001
1000011111010000000000000011100011
11000000000100111100100001111111111
100011111111001 1000110000000000111
11111111100000111000000000000111111
11000000000010000000000W01111111
 11111111111111100000000000000011
1100001        10001000000011111111
11000011111 1111000111100000111111111
10000000001110000001 100000111
110000011111000111111111110111
11111111 1110111 10111010100011
11111111 1111111 1111111111111
