C 255,255,255

NO ./textures/StoneHitler.xpm
SO ./textures/wall.xpm
WE ./textures/Blue.xpm
EA ./textures/Stoneflag.xpm


F    64,64,64





1111111111111111111111111111111
1111000000000000000000000000001
1111E00000000000000000000000001
1111000000000000000000000000001
1111111111111111111111111111111111111