C 255,255,255

NO ./textures/StoneHitler.xpm
SO ./textures/wall.xpm
WE ./textures/Blue.xpm
EA ./textures/Stoneflag.xpm


F 64,64,    64 



1111111111111111111
10N0000000000000001
1000000000000000001
1111111111111110001
              10001
              10001   
              11111