C 255,255,255

NO ./textures/StoneHitler.xpm
SO ./textures/wall.xpm
WE ./textures/Blue.xpm
EA ./textures/Stoneflag.xpm


F 64,64,    64 

1111111
11000111
1100001111111111111111111
10E0000000000000000000011
1111110011111111111111111
111111100000000000000001
111111111111111111111111
11111000001111100001111
11111000001111100001111
11111010101111100001111
11111111110111111111111
11111111111111111111111
11111000001111100001111
11111000001111100001111
11111000001111100001111
11111000001111100001111
11111111111111111111111
1111111111111111111111 
11111000001111100001111
11111000001111100001111
11111000001111100001111
11111000001111100001111
11111111111111111111111





