C 255,255,255

NO ./textures/StoneHitler.xpm
SO ./textures/wall.xpm
WE ./textures/Blue.xpm
EA ./textures/Stoneflag.xpm


F    64,64,64





0000000000
1111111111
1111000111
1111N00111
1111111111